9 11
WWWWWWWWWWW
WP.o.o...oW
W.WWW.W.W.W
W.o.K.o.o.W
W.WWW.WWW.W
W.o...o...W
W.WWW.WWW.W
W..o.o.o.GW
WWWWWWWWWWW