9 11
WWWWWWWWWWW
WP.o.o.o..W
W.WWWWW.W.W
W.o...o.o.W
W.W.WKW.W.W
W.o...o.o.W
W.WWWWW.W.W
W..o.o.o.GW
WWWWWWWWWWW