7 9
WWWWWWWWW
WP.o.o..W
W.WWW.W.W
W.o.K.o.W
W.WWW.W.W
W..o.o.GW
WWWWWWWWW