7 9
WWWWWWWWW
WP.o.o.CW
W.WWW.W.W
W.o.K.o.W
W.WWW.W.W
WC.o.o.GW
WWWWWWWWW