9 11
WWWWWWWWWWW
WP.o.o.o.CW
W.WWWWW.W.W
W.o.C.o.o.W
W.W.WKW.W.W
W.o.C.o.o.W
W.WWWWW.W.W
WC.o.o.o.GW
WWWWWWWWWWW